0000000000000000000000000
0000000000000000000000000
0000000000000000000000000
0000000000000000000000000
0000000000000000000000000
0000000000000000000000000
0000110110000000000000000
0001111111000110000000000
0000111110001001000000000
0000011100010000100000000
0000001000100000010000000
0000800000000000300000000
0000000000000000000000000
0000000000000000000000000
0000000000000000000000000