0000000000000000000000000
0000000000000000000000000
0000000000000000000000000
0000000000000000000000000
0000000000000000000000000
0000000000000000000000000
0000000000000000000000000
0000000110000000110000000
0000001001000001001000000
0000110000111110000110000
0080000500000000500000000
0000000000000000000000000
0000000000000000000000000
0000000000000000000000000
0000000000000000000000000