0000000000000000000000000
0000000000000000000000000
0000000000000000000000000
0000000000000000000000000
0000000011000000110000000
0000000111100001111000000
0000001120110011201100000
0000011000011110000110000
0000110000001100000011000
0008000000000000000000000
0000000000000000000000000
0000000000000000000000000
0000000000000000000000000
0000000000000000000000000
0000000000000000000000000