0000000000000000000000000
0000000000000000000000000
0000000000000000000000000
0000000000000000000000000
0000000000000000000000000
0000000000000000000000000
0000000000000001000000000
0000001110000011100000000
0000010001000111110000000
0000100000111111111000000
0060000000700000000000000
0000000000000000000000000
0000000000000000000000000
0000000000000000000000000
0000000000000000000000000