0000000000000000000000000
0000000000000000000000000
0000000000000000000000000
0000000000000000000000000
0000000000000000000000000
0000000000000000000000000
0000000000000000000000000
0011111111110000000000000
0011111111110000000000000
0011111111110000000000000
0080000000000000300300000
0000000000000000000000000
0000000000000000000000000
0000000000000000000000000
0000000000000000000000000