0000000000000000000000000
0000000000000000000000000
0000000000000000000000000
0000000001100011000000000
0000000011110111100000000
0000000011111111100000000
0000000011211121100000000
0000000001111111000000000
0000000000111110000000000
0000000000011100000000000
0000000000001000000000000
0008000000000000000000000
0000000000000000000000000
0000000000000000000000000
0000000000000000000000000