0000000000000000000000000
0000000000000000000000000
0000000000000000000000000
0000000000000000000000000
0000000000000000000000000
0000000000000000000000000
0000000000000000000000000
0000000011100000011100000
0000000100010000100010000
0000011000001111000001100
0006000000006000000006000
0000000000000000000000000
0000000000000000000000000
0000000000000000000000000
0000000000000000000000000