0000040000000000000000000
0000000000000000000000000
0000000000000000000000000
0000000000000000000000000
0000000000000000000000000
0000000000000000000000000
0000000000000009000000001
0000000000000010100000010
0000000000000100010000100
0000011111101000001111000
0080000000000005000000000
0000000000000000000000000
0000000000000000000000000
0000000000000000000000000
0000000000000000000000000